HPPHHHHHPP	DiscreteStructures: 54
PHHHPPPHHH	DiscreteStructures: 115
HPHHHPHHPP	DiscreteStructures: 55
HHHHPPPHPH	DiscreteStructures: 21
HHPPHHHPPH	DiscreteStructures: 10
HPHHHHPPHP	DiscreteStructures: 24
HPHHPHHPHP	DiscreteStructures: 35
HPHHHPPHHP	DiscreteStructures: 26
HPPHHPHHHP	DiscreteStructures: 34
HPHHHPHPHP	DiscreteStructures: 122
PHPPHHHPHH	DiscreteStructures: 49
PHHHHHPPHP	DiscreteStructures: 11
HPPHHHPPHH	DiscreteStructures: 8
HPHPHHHHPP	DiscreteStructures: 40
PHPHHHPPHH	DiscreteStructures: 18
HHHHPPHHPP	DiscreteStructures: 52
PHPHHPHHHP	DiscreteStructures: 44
HHHPPHHHPP	DiscreteStructures: 40
HHPPHPHHPH	DiscreteStructures: 19
HHPHHPHPPH	DiscreteStructures: 10
PPHHHHHHPP	DiscreteStructures: 253
HHPHPHHHPP	DiscreteStructures: 42
PHHHHHPPPH	DiscreteStructures: 137
HHPHHHPPPH	DiscreteStructures: 33
HPHHHHHPPP	DiscreteStructures: 375
HHPHPHPHHP	DiscreteStructures: 5
HHHPPPHHHP	DiscreteStructures: 111
HHPHPHHPHP	DiscreteStructures: 49
HHPHHPPHHP	DiscreteStructures: 55
HPPPHPHHHH	DiscreteStructures: 20
PHPHHPHPHH	DiscreteStructures: 58
HPPHPPHHHH	DiscreteStructures: 7
HHHHPPPPHH	DiscreteStructures: 22
PHPHPHHPHH	DiscreteStructures: 19
HPHHPHPHPH	DiscreteStructures: 4
HHPPPHPHHH	DiscreteStructures: 17
PHHPPHHHHP	DiscreteStructures: 32
PHHHPHHPHP	DiscreteStructures: 39
PPHHPPHHHH	DiscreteStructures: 64
PHPHPHHHPH	DiscreteStructures: 141
PPHHPHHHPH	DiscreteStructures: 65
HHHHPHPPHP	DiscreteStructures: 38
HPHHHPHPPH	DiscreteStructures: 11
HHPPHPHPHH	DiscreteStructures: 6
PHHHPHPPHH	DiscreteStructures: 23
HPHPHHPPHH	DiscreteStructures: 5
PPHHHHHPPH	DiscreteStructures: 64
HPHHHHPHPP	DiscreteStructures: 117
PHHPPPHHHH	DiscreteStructures: 11
PHPHHHHHPP	DiscreteStructures: 212
HPHPHHPHPH	DiscreteStructures: 10
PHHHHPPPHH	DiscreteStructures: 12
PHHPHHHHPP	DiscreteStructures: 342
PPPHHHPHHH	DiscreteStructures: 269
HHHHPPHPHP	DiscreteStructures: 10
HPPHHPPHHH	DiscreteStructures: 8
HHHPHPPHPH	DiscreteStructures: 6
PHPPHHPHHH	DiscreteStructures: 19
HHHHPPHPPH	DiscreteStructures: 6
HHPHPPHPHH	DiscreteStructures: 7
HHHPHHPPHP	DiscreteStructures: 16
HHPHPHHPPH	DiscreteStructures: 5
HHPHHPPHPH	DiscreteStructures: 7
PHHPHPPHHH	DiscreteStructures: 47
HPHPHPHPHH	DiscreteStructures: 26
PHHHHPHPPH	DiscreteStructures: 72
HPHHPHHPPH	DiscreteStructures: 17
PHHHPHPHPH	DiscreteStructures: 69
HHHHHPPHPP	DiscreteStructures: 25
HPHPPHHPHH	DiscreteStructures: 7
HHHHPHPPPH	DiscreteStructures: 20
HPPHHPHHPH	DiscreteStructures: 17
PHHHPHHHPP	DiscreteStructures: 234
HHPPHHPPHH	DiscreteStructures: 10
HPHPPHHHPH	DiscreteStructures: 13
PHHHHHPHPP	DiscreteStructures: 219
HPPHHHPHHP	DiscreteStructures: 67
HHHPPPPHHH	DiscreteStructures: 21
HHHPHPHHPP	DiscreteStructures: 25
HHPPPPHHHH	DiscreteStructures: 28
HPPPPHHHHH	DiscreteStructures: 23
PHPHHPHHPH	DiscreteStructures: 42
HHHPHPPPHH	DiscreteStructures: 21
HHHPHHPPPH	DiscreteStructures: 33
HPPHHHHPHP	DiscreteStructures: 25
HPPPHHHPHH	DiscreteStructures: 33
PHPHPHHHHP	DiscreteStructures: 19
HPHPHPPHHH	DiscreteStructures: 4
PPHHPHPHHH	DiscreteStructures: 19
HHHPPPHHPH	DiscreteStructures: 40
PPHPHHPHHH	DiscreteStructures: 74
HPHPPHPHHH	DiscreteStructures: 7
PHHHHPPHHP	DiscreteStructures: 35
PPHPHHHPHH	DiscreteStructures: 78
HHHPPHPHHP	DiscreteStructures: 45
HHHPHPHPPH	DiscreteStructures: 6
PPHHHHHPHP	DiscreteStructures: 183
PPHPPHHHHH	DiscreteStructures: 22
PPPHPHHHHH	DiscreteStructures: 227
HHHHHHPPPP	DiscreteStructures: 419
HHPPHPHHHP	DiscreteStructures: 31
HPHPHHPHHP	DiscreteStructures: 40
HPHHPPHPHH	DiscreteStructures: 8
HHHHPPPHHP	DiscreteStructures: 10
HHPHPPPHHH	DiscreteStructures: 22
HHHPPHHPHP	DiscreteStructures: 20
HHHPHPPHHP	DiscreteStructures: 27
PHHHHPHHPP	DiscreteStructures: 333
HHHPHPHPHP	DiscreteStructures: 58
PHHHHPHPHP	DiscreteStructures: 21
HPPHHHPHPH	DiscreteStructures: 7
HHPPPHHHPH	DiscreteStructures: 41
PHHHPPHHPH	DiscreteStructures: 50
HHPHPPHHHP	DiscreteStructures: 44
PHHHPHPHHP	DiscreteStructures: 16
PHPHHHHPHP	DiscreteStructures: 53
HHPPPHHPHH	DiscreteStructures: 28
HPPHPHHPHH	DiscreteStructures: 9
PPHHHPHHPH	DiscreteStructures: 100
HHPHHHHPPP	DiscreteStructures: 480
PHPPHHHHHP	DiscreteStructures: 14
HPHPPHHHHP	DiscreteStructures: 24
PPHHHHPPHH	DiscreteStructures: 47
PHHPHHPHPH	DiscreteStructures: 39
HPHHHHPPPH	DiscreteStructures: 57
HHHPPHPPHH	DiscreteStructures: 5
PHHPHPHPHH	DiscreteStructures: 6
HHHPPHPHPH	DiscreteStructures: 4
HHHHPHHPPP	DiscreteStructures: 490
PPPHHHHPHH	DiscreteStructures: 474
HPPHHPHPHH	DiscreteStructures: 4
PHPHHHHPPH	DiscreteStructures: 31
HHPPHHPHHP	DiscreteStructures: 62
HHPHHPHHPP	DiscreteStructures: 62
PHPPHPHHHH	DiscreteStructures: 47
PHHPHHHPHP	DiscreteStructures: 28
PHPHPPHHHH	DiscreteStructures: 10
HPHHPHHHPP	DiscreteStructures: 89
PHHPHHHPPH	DiscreteStructures: 80
HPPPHHHHHP	DiscreteStructures: 133
HPPHHHHPPH	DiscreteStructures: 9
HPHPHHHPHP	DiscreteStructures: 121
HPPHPHPHHH	DiscreteStructures: 4
HHHHHPPPHP	DiscreteStructures: 70
PHPHPHPHHH	DiscreteStructures: 47
PPHPHHHHHP	DiscreteStructures: 213
HHHPHHPHPP	DiscreteStructures: 79
PPHHPHHPHH	DiscreteStructures: 62
HHPHPPHHPH	DiscreteStructures: 10
PHHHPHHPPH	DiscreteStructures: 42
PHHHHPPHPH	DiscreteStructures: 23
PHHPPHHHPH	DiscreteStructures: 28
PPHHHPHPHH	DiscreteStructures: 49
HPHHPHPPHH	DiscreteStructures: 13
PHHPHHPPHH	DiscreteStructures: 58
PHHPHHPHHP	DiscreteStructures: 36
HPHPHPHHHP	DiscreteStructures: 69
PHHPHPHHHP	DiscreteStructures: 18
HPHPHPHHPH	DiscreteStructures: 4
HHHPPHHPPH	DiscreteStructures: 7
HHPHHPHPHP	DiscreteStructures: 21
PHPPHHHHPH	DiscreteStructures: 30
HHPPPHHHHP	DiscreteStructures: 9
HHPPHHPHPH	DiscreteStructures: 4
HPHPHHHPPH	DiscreteStructures: 6
HPPHPHHHHP	DiscreteStructures: 58
HPHHHPPPHH	DiscreteStructures: 34
PHHHPPHPHH	DiscreteStructures: 51
HPHHPPHHHP	DiscreteStructures: 39
PHPHHHPHPH	DiscreteStructures: 127
HPHHHPPHPH	DiscreteStructures: 15
HHPHHPPPHH	DiscreteStructures: 28
PPHHHPPHHH	DiscreteStructures: 39
PHPHHHPHHP	DiscreteStructures: 30
HHPPHHHPHP	DiscreteStructures: 18
HHHHHPPPPH	DiscreteStructures: 24
PPPHHPHHHH	DiscreteStructures: 520
HHPPHHHHPP	DiscreteStructures: 55
HHHPHHHPPP	DiscreteStructures: 301
HHPPHPPHHH	DiscreteStructures: 5
PPHHHHPHHP	DiscreteStructures: 323
PHPPPHHHHH	DiscreteStructures: 74
HHHPPPHPHH	DiscreteStructures: 23
PPPHHHHHHP	DiscreteStructures: 220
HPPPHHPHHH	DiscreteStructures: 33
HHPHPHPPHH	DiscreteStructures: 4
PHPHHPPHHH	DiscreteStructures: 23
PPHPHHHHPH	DiscreteStructures: 119
HPHHPPPHHH	DiscreteStructures: 37
HHPHPHPHPH	DiscreteStructures: 28
PPHPHPHHHH	DiscreteStructures: 50
PHHPHPHHPH	DiscreteStructures: 80
HPHPPPHHHH	DiscreteStructures: 18
PHHHPPHHHP	DiscreteStructures: 22
PPPPHHHHHH	DiscreteStructures: 424
PHHPPHHPHH	DiscreteStructures: 54
HPPHPHHHPH	DiscreteStructures: 13
HHPHHHPHPP	DiscreteStructures: 77
HPPPHHHHPH	DiscreteStructures: 57
PHHHHHHPPP	DiscreteStructures: 245
PHHPPHPHHH	DiscreteStructures: 23
PPHHHPHHHP	DiscreteStructures: 233
HHPHHHPPHP	DiscreteStructures: 41
HHHHHPHPPP	DiscreteStructures: 239
PPHHHHPHPH	DiscreteStructures: 39
HPHHPPHHPH	DiscreteStructures: 25
PPHHPHHHHP	DiscreteStructures: 302
HHHHPHPHPP	DiscreteStructures: 50
PPPHHHHHPH	DiscreteStructures: 408
HPHHPHPHHP	DiscreteStructures: 74
