HHPPPH	DiscreteStructures: 7
HHHPPP	DiscreteStructures: 94
HPHPHP	DiscreteStructures: 94
HPHHPP	DiscreteStructures: 17
HHPHPP	DiscreteStructures: 17
PPPHHH	DiscreteStructures: 94
PHHPPH	DiscreteStructures: 18
HPPHPH	DiscreteStructures: 2
PHPPHH	DiscreteStructures: 9
PHPHHP	DiscreteStructures: 9
PPHPHH	DiscreteStructures: 18
PPHHHP	DiscreteStructures: 94
PPHHPH	DiscreteStructures: 18
HPPPHH	DiscreteStructures: 7
HPHPPH	DiscreteStructures: 3
HHPPHP	DiscreteStructures: 9
PHHPHP	DiscreteStructures: 9
HPPHHP	DiscreteStructures: 17
PHHHPP	DiscreteStructures: 94
PHPHPH	DiscreteStructures: 94
